%%%%%%%%%%%%%%%%%%%%
%......%G  G%......%
%..%...%%  %%...%..%
%.%..%........%..%.%
%..%.%.%%%%%%.%.%..%
%........P.........%
%%%%%%%%%%%%%%%%%%%%
