%%%%%%%%%%%%%%%%%%%%
%%......G  G%......%
%..%%%%%%  %%%%%%..%
%.%..%..GG....%..%.%
%..%.%.%%  %%.%.%..%
%%.......P........%%
%%%%%%%%%%%%%%%%%%%%
