%%%%%%%%%%%%%%%
%...% .. .%  .%
%.%.% .   % % %
%.%... G . .%.%
%.%. .      %.%
%.% ..   P  %.%
%%%%%%%%%%%%%%%
