%%%%%%%%%%%%%%%
%. . ..%G  G%.%
%..%. .%%  %..%
%.%..%. . . ..%
%..%.%.      .%
%. .. . .P. . %
%%%%%%%%%%%%%%%
