%%%%%%%%
%P     %
% .% . %
%  G   %
% .% . %
%     G%
%%%%%%%%
